"filename", "language", "C++", "Markdown", "comment", "blank", "total"
"/home/sun/Webserver1/Mywebserver/LOG/inc/log.h", "C++", 13, 0, 0, 12, 25
"/home/sun/Webserver1/Mywebserver/README.md", "Markdown", 0, 2, 0, 1, 3
"/home/sun/Webserver1/Mywebserver/TCP/inc/Channel.h", "C++", 54, 0, 4, 28, 86
"/home/sun/Webserver1/Mywebserver/TCP/inc/Epoller.h", "C++", 36, 0, 7, 17, 60
"/home/sun/Webserver1/Mywebserver/TCP/inc/EventLoop.h", "C++", 47, 0, 10, 26, 83
"/home/sun/Webserver1/Mywebserver/TCP/inc/EventLoopThread.h", "C++", 22, 0, 0, 9, 31
"/home/sun/Webserver1/Mywebserver/TCP/src/Channel.cpp", "C++", 29, 0, 1, 10, 40
"/home/sun/Webserver1/Mywebserver/TCP/src/Epoller.cpp", "C++", 112, 0, 28, 14, 154
"/home/sun/Webserver1/Mywebserver/TCP/src/EventLoop.cpp", "C++", 145, 0, 28, 33, 206
"/home/sun/Webserver1/Mywebserver/TCP/src/EventLoopThread.cpp", "C++", 28, 0, 1, 9, 38
"/home/sun/Webserver1/Mywebserver/main.cpp", "C++", 59, 0, 10, 24, 93
"Total", "-", 545, 2, 89, 183, 819